####################
## ##   ##### ##   # 
0                  #
#####TTT## ## ######
#            ..... # 
#   TTTT TT###TTTTT#       
#   #              #  
#   #              #  
#   #    TTTTT     # 
#   #     #####    #       
#   #    S         #  
#   #             C#  
#        T     ######      
#      TT          # 
#        T  ..     # 
#        T  ...    # 
#     TTT    ..    # 
#                  # 
###+          ######
####################

          